##North America
#Canada
NEW = "countries/Commonwealth.txt" #Newfoundland
QUE = "countries/Commonwealth.txt" #Quebec

#Mexico
CED = "countries/SouthAmerican.txt" #Cedillo
MCT = "countries/SouthAmerican.txt" #Cristero
PNR = "countries/SouthAmerican.txt" #Constituionalists
PLM = "countries/SouthAmerican.txt" #Magonists
VIL = "countries/SouthAmerican.txt"	#Villa

##Africa
AEF = "countries/African.txt" #French Equitorial Africa
AOF = "countries/African.txt" #French West Africa
AJU = "countries/African.txt" #Ajuran(Kelafo)
AWS = "countries/African.txt" #Aussa Sultanate
FRE = "countries/WestEurope.txt"  #French govt exile
IEA = "countries/WestEurope.txt" #Italian East Africa
TUA = "countries/African.txt" #Kel Ahaggar
TRP = "countries/African.txt"  #Tripoli


##Europe
CHE = "countries/WestEurope.txt" #Chetniks
ITM = "countries/WestEurope.txt" #Italian Military
ITS = "countries/WestEurope.txt" #Italian Socialists
LAJ = "countries/WestEurope.txt" #Lajtabánság
DAN = "countries/WestEurope.txt" #Danzig
MEM = "countries/WestEurope.txt" #Memel

#Middle East
ASR = "countries/MiddleEast.txt" #Asir
HEJ = "countries/MiddleEast.txt" #Hejaz
ISZ = "countries/WestEurope.txt" #International Zone of Straits
JAB = "countries/MiddleEast.txt" #Jabal Shammar
OMN = "countries/MiddleEast.txt" #Imam of Oman


#Persia
ARB = "countries/MiddleEast.txt" #Arabistab
AZD = "countries/MiddleEast.txt" #Azadistan
BLC = "countries/MiddleEast.txt" #Balochistan
GIL = "countries/MiddleEast.txt" #Gilan
KHO = "countries/MiddleEast.txt" #Khorasan

#China
HOT = "countries/MiddleEast.txt" #Hotan Sultanate
KUM = "countries/Asian.txt"	#Kumul Khanate



